1 1 1 1 1 1 1 1 1 1 1 1 1 1
1 Y K C 1 L O C K 1 0 1 0 1
1 L 1 0 1 1 1 1 1 1 0 1 0 1
1 R 1 0 0 0 7 7 7 0 0 0 0 1
1 E 1 E 1 1 1 1 1 1 1 1 1 1
1 W O P 1 1 1 up 1 1 1 1 1 1
1 1 1 1 1 1 left 2 right 1 1 1 1 1
1 1 1 1 1 1 1 down 1 1 1 1 1 1
1 1 1 1 1 1 1 1 1 1 1 1 1 1
